1111111111111111111111111111
1************11************1
1*1111*11111*11*11111*1111*1
1P1111*11111*11*11111*1111P1
1*1111*11111*11*11111*1111*1
1**************************1
1*1111*11*11111111*11*1111*1
1*1111*11*11111111*11*1111*1
1******11****11****11******1
111111*11111011011111*111111
111111*11111011011111*111111
111111*11000000000011*111111
111111*11011100111011*111111
111111*11010000001011*111111
T00000*00010000001000*00000T
111111*11010234501011*111111
111111*11011111111011*111111
111111*1100000S000011*111111
111111*11011111111011*111111
111111*11011111111011*111111
1************11************1
1*1111*11111*11*11111*1111*1
1*1111*11111*11*11111*1111*1
1P**11****************11**P1
111*11*11*11111111*11*11*111
111*11*11*11111111*11*11*111
1******11****11****11******1
1*1111111111*11*1111111111*1
1*1111111111*11*1111111111*1
1**************************1
1111111111111111111111111111

